#################
#''#'''#''''''''#
#''#'''###''''#'#
#'''''''#'''#'''#
#'''#'''''''#'''#
#'#'''#'''''''''#
#'''''''''''''''#
#################