########################################''#
###'''''''''''''''''''''''''''''''''''##''#
##'''''''''''''''''''''''''''''''''''''#''#
#''''############################''''''''##
#'''##''''''#''''''#'''''''#''''##''''''''#
#''##'''''''#''''''''''''''''''##'''''''''#
#''#''''#'''''''#'''''#'''''''##''''''''''#
#''#''''#'''''''#'''###''''''##'''''''''''#
#''#''###############'''''''##''''''''#'''#
#''#''#''''''''''''''''''''##'''''''''#'''#
#''#''#''''''''''''''''''###''''''''''#'''#
#''#''##''#'##############''''''''''''#'###
#''#'''#''''''''''''''''''''''''''##'##'#''
#''''''#''''''''''''''''''''''''''''''''#'#
#''''''#''''''''''''''''''''''''''''''''''#
###########################################
