#############################################
#'''''''''#'''''''''''''''''#'''''''''#'''''#
#'''''#'''#'''''#'''''''''''#'''''''''#'''''#
#'''''#'''''''''#'''''''''''''''''#'''''''''#
#'###'#'''''''''''''''''''''''''''#'''####''#
#'''''''''#'''''''''''''''''''''''#'''''''''#
#'''''''''#'''''###'''''''###'''''#'''''''''#
###''######'''''#'''''''''''#''''''''########
#'''''''''''''''''''''''''''''''''''''''''''#
#######''''''##'''''''''''''''##''''''#######
#'''''''''''''''''''''''''''''''''''''''''''#
#''######'''''''#'''''''''''#'''''########''#
#'''''''''''''''###'''''''###'''''#'''''''''#
#'''''''''#'''''''''''''''''''''''#'''''''''#
###''##'''#'''''''''''''''''''''''''''#''####
#'''''#'''#'''''''''''''''''#'''''''''#'''''#
#'''''''''#'''''#'''''''''''#'''''#'''#'''''#
#'''''#'''''''''#'''''''''''''''''#'''''''''#
#############################################
