#############################################
#'''''''''''''''''''''''''''''''''''''''''''#
#'#########################################'#
#'#'''''''''''''''''''''''''''''''''''''''#'#
#'#'#####################################'#'#
#'#'#'''''''''''''''''''''''''''''''''''#'#'#
#'#'#'#################################'#'#'#
#'#'#'#'#''#'''''''''''''''''''''''#''#'#'#'#
#'#'#'#'#''#'''''''''''''''''''''''#''#'#'#'#
#'#'#'#'#''#'''''''''''''''''''''''#''#'#'#'#
#'#'#'#################################'#'#'#
#'#'#'''''''''''''''''''''''''''''''''''#'#'#
#'#'#####################################'#'#
#'#'''''''''''''''''''''''''''''''''''''''#'#
#'#########################################'#
#'''''''''''''''''''''''''''''''''''''''''''#
#############################################
