'''''''''''''''''''''''''
'.''.''.'''''''''''''''''
''.@''@''''''''########''
''''@@'@'''''''#''''''d''
''''@''''''''''#''''''#''
''''@''''''''''@''''''#''
ddd#d#ddddddddd#dddddd#dd
ddd#'#ddddddddddddddddddd
####d############dddddd##
#''''''''''d'''''''''@''#
#''''''''''d'''''''''d''#
#''''''''''d'''''''''d''#
#''''''''''d'''''''''@''#
#''''''''''d'''''''''d''#
############dddddddddddd#
