#############################################
''''''@'''#'''''#'''''''''''#'''''@'''#'''''#
#'''''#'''#'''''#'''''''''''#'''''@'''#'''''#
#'''''#'''@'''''''''''''''''''''''#'''@'''''#
#@###@#'''@'''''ddddddddddddd'''''#'''####@@#
#'''''''''#'''''d'''''''''''d'''''#'''''''''#
#'''''''''#'''''''''''''''''''''''#'''''''''#
###@@######'''''d''dd'''dd''d'''''@@####@####
#'''''''''''''''d'''''''''''d'''''''''''''''#
#########''''###d'''''#'''''d###''''#########
#'''''''''''''''d'''''''''''d'''''''''''''''#
#@@######@@'''''d''dd'''dd''d'''''########@@#
#'''''''''@'''''''''''''''''''''''#'''''''''#
#'''''''''#'''''d'''''''''''d'''''#'''''''''#
###@@##'''#'''''ddddddddddddd'''''@'''#@@####
#'''''#'''#'''''''''''''''''''''''@'''#'''''#
#'''''@'''#'''''#'''''''''''#'''''#'''#'''''#
#'''''#'''@'''''#'''''''''''#'''''#'''@'''''#
#############################################
