#########################
#''''''''d''@@'''''d''''#
#''@''''''''''d'''@''''d#
#'''''''''@'''''''''''d'#
###################'''''#
#'''''d'''''d'''''''''''#
#'''''@'''''d''''''''ddd#
#'''''d'''''d''''''''d''#
#'''''d'''''@''''''''d''#
#########################
